ALLOWABLE_DEAL_TYPES	CCODS (table_name), CSLSTG (table_name)
ALLOWABLE_DEAL_TYPES_GROUPS	CCODS (parent tables)
ALLOWABLE_DEAL_TYPES_VW1	CCODS (views), CCODS (synonyms)
AOT_AUTH	CSLSTG (table_name)
ARTT_DETAIL	FRR (table_name)
BUS_PARTY	CCODS (parent tables), CCODS (parent tables), CCODS (parent tables)
BUS_PARTY_INDUSTRY	CCODS (table_name), CSLSTG (table_name)
BUS_PARTY_REF	CCODS (table_name), CSLSTG (table_name)
BUS_PARTY_REGULATORY	CSLSTG (table_name)
BUS_PARTY_RELATIONSHIP	CCODS (table_name), CSLSTG (table_name)
BUS_PARTY_ROLE	CSLSTG (table_name)
BUS_PARTY_WIRE_INSTRUCT	CSLSTG (table_name)
CIAO_EVENT_DATA_PKG	CCODS (packages)
CIAO_PHYGAS_TRADE_LEG_VW3	CCODS (views), CCODS (synonyms)
CIAO_RULE_PKG	CCODS (packages)
CIAO_TRADE_CHANGE_PKG	CCODS (packages)
CIAO_TRADE_LEG_DEAL_PRICE_VW3	CCODS (views), CCODS (synonyms)
CIAO_TRADE_LEG_VW3	CCODS (views), CCODS (synonyms)
CIAO_TRADE_SEARCH_PKG	CCODS (packages), CCODS (synonyms)
CIAO_UNCONFIRMED_DEALS_VW	CCODS (views)
CMDTY_GRP_PROD_UTIL	CCODS (table_name), CSLSTG (table_name)
COMMODITY	CSLSTG (table_name)
COMMODITY_GROUP	CCODS (parent tables)
CONFIRM_CHASING_VW	CCODS (views)
CONF_COMMENTS	CCODS (table_name)
CONF_COMMENTS_VW1	CCODS (views), CCODS (synonyms)
CONF_COMM_CODE	CCODS (parent tables)
CONF_DOCS	CCODS (parent tables)
CONF_STAKEHOLDER_STATUES	CSLSTG (table_name)
CONF_STATUS_DOCS	CCODS (table_name)
CONF_STAT_DTL_INT	CSLSTG (table_name)
CONF_TECH_STATUS	CSLSTG (table_name)
CONF_TRANSP_REF	CCODS (table_name)
CONF_TRANSP_REF_TYPE	CCODS (parent tables)
CONF_TRANSP_REF_VW1	CCODS (views), CCODS (synonyms)
CONTACT	CCODS (parent tables)
CONVERSION_PROFILE	CCODS (table_name), CSLSTG (table_name)
DOCUMENTATION	CCODS (table_name), CSLSTG (table_name)
EMISSION_OPTION_LEG	CCODS (table_name), CSLSTG (table_name)
EMISSION_OPTION_LEG_VW1	CCODS (views), CCODS (synonyms)
EMISSION_OPTION_LEG_VW2	CCODS (views), CCODS (synonyms)
FACILITY	CCODS (parent tables), CCODS (parent tables)
FACILITY_ADDRESS	CCODS (table_name), CSLSTG (table_name)
FACILITY_ALT_REF_TYPE	CSLSTG (table_name)
FACILITY_AUTH_USAGE_TYPE	CSLSTG (table_name)
FACILITY_CLASS	CSLSTG (table_name)
FACILITY_MEAS_ACTIVITY_TYPE	CSLSTG (table_name)
FACILITY_POINT_TYPE	CSLSTG (table_name)
FACILITY_TYPE	CSLSTG (table_name)
FAC_ASSN_ROLE	CSLSTG (table_name)
FAC_BUS_PARTY_REL_ROLE	CSLSTG (table_name)
FLAG_TRANSLATION	CCODS (parent tables)
FN_GET_CIAO_SAVE_VERSION	CCODS (functions), CCODS (synonyms)
FRR_IM_TRADE_EXCLUSION	REGSVC (table_name)
FRR_PORTAL_MIFID_MAPPING_AUDIT	FRR (table_name)
FRR_PORTFOLIO_COMMODITY	CSLSTG (table_name)
FRR_PRODUCT_ATTRIBUTES	CCODS (table_name), FRR (table_name), FRR (child tables)
FRR_REQUIRED_ATTRIBUTES	CCODS (parent tables), FRR (parent tables), FRR (table_name)
FRR_TRADE_SUBMIT	FRR (table_name)
FRR_VALUATION_SUBMIT	FRR (table_name)
FRR_VM_TRADE_EXCLUSION	REGSVC (table_name)
FRR_VM_TRADE_STG	REGSVC (table_name)
FUTURE_TRADE	CCODS (table_name), CSLSTG (table_name)
GAS_VALUATION_POSITION	CCODS (table_name), CSLSTG (table_name)
GAS_VALUATION_POSITION_S_VW1	CSLSTG (views)
GAS_VALUATION_POSITION_VW1	CCODS (views), CCODS (synonyms)
GEOPOLITICAL_REF	CSLSTG (table_name)
HS_ALLOWABLE_DEAL_TYPES	CCODS (table_name)
HS_BUS_DOMAIN	CCODS (table_name)
HS_BUS_PARTY_INDUSTRY	CCODS (table_name)
HS_BUS_PARTY_REF	CCODS (table_name)
HS_BUS_PARTY_RELATIONSHIP	CCODS (table_name)
HS_BUS_PARTY_ROLE	CCODS (table_name)
HS_CMDTY_GRP_PROD_UTIL	CCODS (table_name)
HS_CONF_COMMENTS	CCODS (table_name)
HS_CONF_FILE_TYPE	CCODS (table_name)
HS_CONF_STAKEHOLDER_STATUES	CCODS (table_name)
HS_CONF_STATUS_DOCS	CCODS (table_name)
HS_CONTACT_ROLE	CCODS (table_name)
HS_CONTRACT_DEVIATION	CCODS (table_name)
HS_CONTRACT_OBLIG_AGRMT	CCODS (table_name)
HS_CONTRACT_OBLIG_AGRMT_VW1	CCODS (views), CCODS (synonyms)
HS_CONTRACT_STATUS	CCODS (table_name)
HS_CONTRACT_STATUS_DETAIL	CCODS (table_name)
HS_CONVERSION_PROFILE	CCODS (table_name)
HS_DOCUMENTATION	CCODS (table_name)
HS_EVALUATION_DATE_RANGE	CCODS (table_name)
HS_EVALUATION_DATE_RULES	CCODS (table_name)
HS_FACILITY_ADDRESS	CCODS (table_name)
HS_FORMULA_COMP_BUS_TYPE	CCODS (table_name)
HS_FORMULA_FUNCTION	CCODS (table_name)
HS_FORMULA_OPERATOR	CCODS (table_name)
HS_FUTURE_TRADE	CCODS (table_name)
HS_GAS_VALUATION_POSITION	CCODS (table_name)
HS_GAS_VALUATION_POSITION_VW1	CCODS (views), CCODS (synonyms)
HS_GEOPOLITICAL_REF	CCODS (table_name)
HS_ISDA_PROTOCOL_STATUS	CCODS (table_name)
HS_ISDA_PROTOCOL_STATUS_VW1	CCODS (views), CCODS (synonyms)
HS_LOCATION_DIRECTION_TYPE	CCODS (table_name)
HS_LOCATION_DIRECTION_TYPE_VW1	CCODS (views), CCODS (synonyms)
HS_NGL_DELIVERY_TERMS	CCODS (table_name)
HS_NGL_DELIVERY_TERMS_VW1	CCODS (views), CCODS (synonyms)
HS_NGL_DLVRY_INTENT_USAGE	CCODS (table_name)
HS_NGL_DLVRY_INTENT_USAGE_VW1	CCODS (views), CCODS (synonyms)
HS_NGL_IMBAL_CLAUSE	CCODS (table_name)
HS_NGL_IMBAL_CLAUSE_VW1	CCODS (views), CCODS (synonyms)
HS_NGL_IMBAL_TREAT_TYPE	CCODS (table_name)
HS_NGL_IMBAL_TREAT_TYPE_VW1	CCODS (views), CCODS (synonyms)
HS_NGL_PRODUCT_GRADE	CCODS (table_name)
HS_NGL_PRODUCT_GRADE_VW1	CCODS (views), CCODS (synonyms)
HS_OPTION_TRADE	CCODS (table_name)
HS_OPT_VALUATION_POSITION	CCODS (table_name)
HS_OPT_VALUATION_POSITION_VW1	CCODS (views), CCODS (synonyms)
HS_PAYMENT_DAY_OFFSET_TYPE	CCODS (table_name)
HS_PAYMENT_DAY_OFFSET_TYPE_VW1	CCODS (views), CCODS (synonyms)
HS_PERFORMANCE_OBLIGATION	CCODS (table_name)
HS_PERFORMANCE_OBLIGATION_VW1	CCODS (views), CCODS (synonyms)
HS_PHYSICAL_OPTION_TRADE_LEG	CCODS (table_name)
HS_PORTFOLIO_ATTR_RELATIONSHIP	CCODS (table_name)
HS_PRE_PAYMENT_TERM	CCODS (table_name)
HS_PRE_PAYMENT_TERM_VW1	CCODS (views), CCODS (synonyms)
HS_PRICE_VALUE_EXT_FORMULA	CCODS (table_name)
HS_PRICE_VALUE_EXT_FORMULA_VW1	CCODS (views), CCODS (synonyms)
HS_SERIES_DEF_PRC_TYP_BUS_USG	CCODS (table_name)
HS_SUB_ASSET_CLASS_MAPPING	CCODS (table_name)
HS_TITLE_TRANSFER_TYPES	CCODS (table_name)
HS_TITLE_TRANSFER_TYPES_VW1	CCODS (views), CCODS (synonyms)
HS_TRADE_DELIVERY_INTENT	CCODS (table_name)
HS_TRADE_DELIVERY_INTENT_VW1	CCODS (views), CCODS (synonyms)
HS_TRADE_GROUP_STATUS	CCODS (table_name)
HS_TRADE_LEG_VAL_OPT_QTY	CCODS (table_name)
HS_TRADE_LEG_VAL_OPT_QTY_VW1	CCODS (views), CCODS (synonyms)
HS_TRADE_LEG_VAL_QTY	CCODS (table_name)
HS_TRADE_LEG_VAL_QTY_VW1	CCODS (views), CCODS (synonyms)
HS_TRADE_LIFECYCLE_STATUSES	CCODS (table_name)
HS_TRADE_STATE_TRACKING	CCODS (table_name)
HS_TRADE_TERMS	CCODS (table_name)
HS_TRADE_TERMS_VW1	CCODS (views), CCODS (synonyms)
HS_TRANSPORTATION_CHARGE	CCODS (table_name)
HS_TRANSPORTATION_METHOD	CCODS (table_name)
HS_TRANSPORTATION_METHOD_VW1	CCODS (views), CCODS (synonyms)
HS_UOM_CONVERSION	CCODS (table_name)
HS_VALUATION_SOURCE	CCODS (table_name)
ISDA_BUS_PARTY	CCODS (parent tables)
ISDA_PROTOCOL_STATUS	CCODS (table_name), CSLSTG (table_name)
ISDA_PROTOCOL_STATUS_VW1	CCODS (views), CCODS (synonyms)
ISDA_REVIEW_PROCESS	CCODS (parent tables)
LIFECYCLE_STATUS	CSLSTG (table_name)
LOCATION_DIRECTION_TYPE	CCODS (table_name), CSLSTG (table_name)
LOCATION_DIRECTION_TYPE_S_VW1	CSLSTG (views)
LOCATION_DIRECTION_TYPE_VW1	CCODS (views), CCODS (synonyms)
NGL_DELIVERY_TERMS	CCODS (table_name), CSLSTG (table_name)
NGL_DELIVERY_TERMS_S_VW1	CSLSTG (views)
NGL_DELIVERY_TERMS_VW1	CCODS (views), CCODS (synonyms)
NGL_DLVRY_INTENT_USAGE	CCODS (table_name)
NGL_DLVRY_INTENT_USAGE_VW1	CCODS (views), CCODS (synonyms)
NGL_DLVRY_INTENT_USAGE_VW2	CCODS (views), CCODS (synonyms), CCODS (views), CCODS (synonyms)
NGL_IMBAL_TREAT_TYPE	CSLSTG (table_name)
NGL_IMBAL_TREAT_TYPE_S_VW1	CSLSTG (views)
NGL_PHY_LEG_VW2	CCODS (views), CCODS (synonyms)
ODS_STAGE_PURGE	CCODS (stored procedures)
OPTION_TRADE	CCODS (table_name), CSLSTG (table_name)
OPTION_TRADE_LEG_VW3	CCODS (views), CCODS (synonyms)
OPT_VALUATION_POSITION	CCODS (table_name), CSLSTG (table_name)
OPT_VALUATION_POSITION_S_VW1	CSLSTG (views)
OPT_VALUATION_POSITION_VW1	CCODS (views), CCODS (synonyms)
PARTY_ADDRESS	CCODS (parent tables)
PHYSICAL_OPTION_TRADE_LEG	CCODS (table_name), CSLSTG (table_name)
PHYSICAL_OPTION_TRADE_LEG_VW1	CCODS (views), CCODS (synonyms)
PORTFOLIO	CCODS (parent tables)
PORTFOLIO_ATTRIBUTE	CCODS (parent tables)
PORTFOLIO_ATTR_RELATIONSHIP	CCODS (table_name), CSLSTG (table_name)
PORTFOLIO_ATTR_RELTNSHIP_VW1	CCODS (views), CCODS (synonyms)
PORTFOLIO_ATTR_VALUES	CCODS (parent tables)
PORTFOLIO_USAGE	CSLSTG (table_name)
PRICE_VALUE	CCODS (parent tables)
PRICE_VALUE_EXT_FORMULA	CCODS (table_name)
PRICE_VALUE_EXT_FORMULA_VW1	CCODS (views), CCODS (synonyms)
PRODUCT	CCODS (parent tables), FRR (table_name), FRR (child tables)
PRODUCT_DEFINITION	CCODS (parent tables), FRR (parent tables)
PRODUCT_GROUP	FRR (parent tables), FRR (table_name)
PTFL_ATTR_INPUT_TYPE	CSLSTG (table_name)
RPT_STP_RUN_VW	CCODS (views)
SEC_USER_AUD	CONTROL (table_name)
SERIES_DEF_PRC_TYP_BUS_USG	CSLSTG (table_name)
SP_CORE_BUSPARTY_PERSISTANCE	CCODS (stored procedures), CSLSTG (stored procedures), CSLSTG (stored procedures)
SP_CORE_IN_CONF_PERSISTANCE	CCODS (stored procedures), CCODS (stored procedures)
SP_CORE_PORTFOLIO_PERSISTANCE	CCODS (stored procedures), CSLSTG (stored procedures), CSLSTG (stored procedures)
SP_CORE_TRD_INSERT_NGLPHYS	CCODS (stored procedures)
SP_CORE_TRD_PRSISTNCE_GASPHYS	CCODS (stored procedures)
SP_CORE_TRD_UPDATE_NGLPHYS	CCODS (stored procedures)
SP_HS_BUSPARTY_PERSISTANCE	CCODS (stored procedures), CCODS (stored procedures)
SP_HS_PORTFOLIO_PERSISTANCE	CCODS (stored procedures), CCODS (stored procedures)
SP_PRICE_VALUE_EXT_FORMULA	CCODS (stored procedures)
SP_UPDT_NGL_DLVR_INTUSG_NGLPHY	CCODS (stored procedures)
STATUS_LOCATION_TRACKING	CCODS (table_name)
SUBMISSION_COMPLIANCE	CONTROL (table_name)
SUB_ASSET_CLASS_MAPPING	CCODS (table_name), CSLSTG (table_name)
SUSPENSE_CATEGORY	CONTROL (table_name)
TITLE_TRANSFER_TYPES	CSLSTG (table_name)
TITLE_TRANSFER_TYPES_S_VW1	CSLSTG (views), CSLSTG (synonyms)
TRADE	CCODS (parent tables), CCODS (parent tables)
TRADE_CONF_STATUS	CCODS (parent tables)
TRADE_DELIVERY_INTENT	CCODS (table_name), CSLSTG (table_name)
TRADE_DELIVERY_INTENT_S_VW1	CSLSTG (views), CSLSTG (synonyms)
TRADE_DELIVERY_INTENT_VW1	CCODS (views), CCODS (synonyms)
TRADE_LEG	CCODS (parent tables)
TRADE_LEG_VAL_OPT_QTY	CCODS (table_name), CSLSTG (table_name)
TRADE_LEG_VAL_OPT_QTY_S_VW1	CSLSTG (views), CSLSTG (synonyms)
TRADE_LEG_VAL_OPT_QTY_VW1	CCODS (views), CCODS (synonyms)
TRADE_LEG_VAL_QTY	CCODS (parent tables), CSLSTG (table_name)
TRADE_LEG_VAL_QTY_S_VW1	CSLSTG (views), CSLSTG (synonyms)
TRADE_STATE	CSLSTG (table_name)
TRADE_TERMS	CSLSTG (table_name)
TRADE_TERMS_S_VW1	CSLSTG (views), CSLSTG (synonyms)
TRADE_TYPE	CCODS (parent tables)
TRADE_TYP_FUNC_CLS	CSLSTG (table_name)
TRANSPORTATION_CHARGE	CCODS (table_name), CSLSTG (table_name)
TRANSPORTATION_CHARGE_VW1	CCODS (views), CCODS (synonyms)
TRANSPORTATION_CHARGE_VW2	CCODS (views), CCODS (synonyms)
TRANSPORTATION_LOCATION_VW2	CCODS (views), CCODS (synonyms)
TRANSPORTATION_METHOD	CSLSTG (table_name)
TRANSP_DELIVERY_TYPE	CCODS (parent tables)
UOM_CONVERSION	CSLSTG (table_name)
VALUATION_POSITION	CCODS (parent tables), CCODS (parent tables)
VALUATION_SOURCE	CSLSTG (table_name)
